XXXXXXXXXXXXXXXXXXXXXXXXXXXXXXXXXXXXXXXXXXXXXXXXXXXXXXXXXXXXXXXXXXXXXXXXXXXXXXXXXXXXXXXXXXXXXXXXXXXXXXXXXXXXXXXXXXXXXXXXXXXXX
XXXXXX                                                              C             XXXXXXXXXXXXXXXXXXXXXXXXXXXXXXXXXXXXXXXXXXX
XXXXXX                            CCCCC                           XXX       C      XXXXXXXXXXXXXXXXXXXXXXXXXXXXXXXXXXXXXXXXXX
XXXXXX                            XXXXXX    XX    XXX        X              X       XXXXXXXXXXXXXXXXXXXXXXXXXXXXXXXXXXXXXXXXX
XXXXXXC     CCC                                       X      XX                      XXXXXXXXXXXXXXXXXXXXXXXXXXXXXXXXXXXXXXXX
XXXXXXXX    XXX            XX           XXX            XX         XX                                                    XXXXX
XXXXXXXX P                            X     X   C                 XXXXX     XXXXXX                                      XXXXX
XXXXXXXXXX         XX         XX  XXXX         XX         XX                     C                     E      E         XXXXX
XXXXXXXXXX       XX               XXXX       XX                         XX       X   XXXXXXXXXXXXXXXXXXXXXXXXXXXXXXXXXXXXXXXX
XXXXXXXX       X       XX  XX     XX    C          XX  XX                           XXXXXXXXXXXXXXXXXXXXXXXXXXXXXXXXXXXXXXXXX
XXXXXX        XXXXXCC  XX  XXX          X     X    XX  XXX           XX            XXXXXXXXXXXXXXXXXXXXXXXXXXXXXXXXXXXXXXXXXX
XXXXXXECCXXXXXXXXXXXX  XX  XXXX CC   XXXX     XXX  XX  XXXX         XXXX       C CXXXXXXXXXXXXXXXXXXXXXXXXXXXXXXXXXXXXXXXXXXX
XXXXXXXXXXXXXXXXXXXXXDDXXDDXXXXXXXXXXXXXXDDDDDXXXDDXXDDXXXXXXDDDDDXXXXXXXDDXXXXXXXXXXXXXXXXXXXXXXXXXXXXXXXXXXXXXXXXXXXXXXXXXX